9
 00000000000000000000000000000000
 00000000000000000000000000000000
 00110000000000000000000000000000
 00111000000000000000000000000000
 00011100000000000000000000000000
 00001110000000000000000000000000
 00000111111100111110000000000000
 00000000000000000000000000000000
 00000000000010000000000000000000
 00000000000001000000000000000000
 00000000000011000000000000000000
 00000000000011000000000000000000
 00000000000001000000000000000000
 00000000000000000000000000000000
                                 9
